1111111111111111111111111111111111111111111111111111111111111111111111111111111
1000000000000000000000000000000000000000000001000000000000000000000000000000001
1000000000000000000000000000000000000000000001000000000000000000000000000000001
1000000000000000000000000000000000000000000001000000000000000000000000000000001
1000000000000000000000000000000000000000000001000000000000000000000000000000001
1000000000000000000000000000000000000000000001000000000000000000000000000000001
1000000000000000000100000000000000000000000000000000000000000000000111111111111
1000000000000000000100000000000000000000000000000000000000000000000000000000001
1000000000000000000100000200000000300000000000000000000000000000000000000000001
1000000000000000000100000000000000000000000000000000000000000000000000000000001
1000000000000000000100000000000000000000000000000000000000000000000000000000001
1000000000000000000100000000000000000000000000000000000000000000000000000000001
1000000000000000000100000000000000000000000000000000000000000000000000000000001
1000000000000000000100000000000000000000000000000000000000000000000000000000001
1111111111111111111111111111111111111111111111111111111111111111111111111111111
