1111111111111111111111111111111111111111111111111111111111111111111111111111111
1000000000000000000000000000000000000000000001000000000000000000000000000000001
1020000000000000000000000000000000000000000001000000000000000000000000000000001
1000000000000000000000000000000000000000000001000000000000000000000000000000001
1000000000000000000000000000000000000000000001000000000000000000000000000000001
1000000000000000000000000000000000000000000001000000000000000000000000000000001
1000000000000000000000000000000000000000000000000000000000000000000000000000001
1000000000000000000000000000000000000000000000000000000000000000000000000000001
1000000000000000000000000000000000300000000000000000000000000000000000000000001
1000000000000000000000000000000000000000000000000000000000000000000000000000001
1000000000000000000000000000000000000000000000000000000000000000000000000000001
1000000000000000000000000000000000000000000000000000000000000000000000000000001
1000000000000000000000000000000000000000000000000000000000000000000000000000001
1000000000000000000000000000000000000000000000000000000000000000000000000000001
1111111111111111111111111111111111111111111111111111111111111111111111111111111
